############*#S
############*#*
#************#*
#*############*
#*#************
#*#*###########
#*#*###########
#*#************
#*#############
#*************E