S######*######E
#######*#######
####****##****#
***#*##*###*###
##*#*######*###
##*#*#*#****###
##*#***#*######
##*#####*######
##*******######
###############