*S######*######
*******#*****##
######*#####*##
######*****#*##
##########*#*##
###********#*##
###*########*##
###*#**********
###*##########*
###**********E*