*************#S
*#############*
*#*************
*#*************
*#############*
*************#*
*************#*
*#############*
*#*************
E#*************