S#**###########
###*###########
**#**********##
#*##########*##
#**********#*##
##########*#*##
###********#*##
###*########*##
###*#*******###
###*##########E