S**************
##############*
*************#*
*#############*
*#*************
*#############*
*************#*
*#############*
*#*************
*#############E