*******S*******
*******#######*
*************#*
**############*
**#************
**###########**
************#**
*******######**
*******#*******
*******E*******