S######*#######
#######*#######
####****#######
***#*##########
##*############
##*****##*#####
######*##*#####
######**#*#####
#######*#******
#######*######E