S#*************
*#*###########*
*#*#*********#*
*###*#########*
*****#*********
*#####*#######*
*#*****#*****#*
*#*#####*#####*
*###*****#*****
*********#####E
