S**************
#**##########**
#**#********#**
#**#********#**
#**########*#**
#*********#*#**
#**########*#**
#**#********#**
#**#*######*#**
####*######*##E