S**************
###############
*******#*******
*****###*******
###############
###############
*****#*********
*****##********
###############
**************E