S************##
############*##
***********#*##
##########*#*##
***********#*##
*###########*##
*##**********##
*##############
**************#
##############E